              111111111111111111111111
              1000000000110000000000001
              1011000001110000002000001
        1111111001000000000000000000001
11111111101100000111000000000000111111
100000000011000001110111111111111
11110111111111011100000010001111111111
111101111111110111010100100000000000001
110000001101010111000000100000000000001
100020000000000011000000100000000000001
10000000000000001101010010001111111111
1100000111010101111101111000111
11110111 1110101 1011110100N1
11111111 1111111 111111111111