R 900 500
NO ./texture/tron0.xpm
SO ./texture/tron2.xpm
WE ./texture/tron2.xpm
EA ./texture/tron0.xpm
S ./texture/zombie1.xpm
F 0,0,0
C 0,0,0


1111111111111111111111111111111111111111111111111111111111111111111111111111111111111111111111111111111111111111111111111111111111111
1000000000000000000000010000000000000000000000020000001000000000000001000000200000000100000000000000001000000000020000000000000000001
1000020000000000000000010000000002000100000000000000001000000002000001000000000020000100000200020000001000200000000000000000200000111
1000000000000000000000000000000000000100000000000200000000000000000001000000000000000100000000000000000000000000020000002000000000011
1000000000000000000000010020000000001000200000000000010000200000020010000200000000001000000200000000010000020000000000000000000000111
1000000000000111111111110000000000000100000000000000001000000000000001000000000000000000000000000000001000000000000000000000000000001
1020000000000100000000011111111111111111111111111111111111111111111111111111111111111111111111111111111111111111111111111111111111111
100000000000010000000001
100000000000010000000001
10000000000001111000N001
100000000000000000000001
100000000000000000000001
11111111011111111111111111111111111111111111111111111111111111111111111111111111111111111111111111111111111111
10000000000000000000000000000000000000000000000000000000000000000000000000000001000000000000000000000010000001
10000200000000000000000000000000000000000000000000000000100000000000000000000001000000000000000000000010000001
10000000000000000000000000000000010000000000000000000000100000000000000000000000000000000000002000000010000001
10000000000000000000000000000000010000002000000000000000100000000000000002000001000000000000000000000010000001
100000000000002000002000000000000000000000000000000000001000000000000000000000010000000000000000000000000000011111111
111111110000000000000000000000000100000000000000000000001000000000000000000000010000000000000000000000000000000000001
       10000000000000000000000000100000000000000000000001020000000000000000000010000000000000000000000000000000000001
       10000000000002000000000000000000000000000000000111000000000000000000000010000000000000000000000100000000000001
       10000000000000000000000011000000000000000000000110000000000000000000000010000000000000000000000100000000000001
       10000000000000000000000011000002000000000000000111000000000000000000000010000000000000020000000100000000000001
       10000000020000000000000000000000000000000000000111000000000000000000000000000000000000000000000100000000000001
       10000000000000000000000011000000000000000000000110000000000000000000000010000000000000000000000100000000000001
       10000000000000000000000011000000000000000000000000000000000000000000000010000000000000000000000000000000000001
       11111111111111111111111111111111111111111111111111111111111111111111111111111111111111111111111111111111111111