R 1280 720
NO ./texture/scia.xpm
SO ./texture/scia.xpm
WE ./texture/scia.xpm
EA ./texture/scia.xpm
S ./texture/moto1.xpm
F 0,0,0
C 0,0,0


        1111111111111111111111111
        1000000000000000000000001
        1000000000000000002000001
        1000000000000020000000001
111111111000000000000000000000001
120000000000000000000111111111111
10000000020000000000000010201
1111011101101101101101101111111111111111111111111111111111111111111111111111111111111111111111111111111111111111111111111111111111
1000000000000000000100000000000000000000010000000011000000000000000000000002001000000000000000000000000000000000000000000000000001
100000000000000000010000000000000000000001000000001000000000000000000000000000100000000000000000000000N000000000000000000000000001
1000000000000000000100000000000000000000010000000011000000000000000000100000001000000000000000000000000000000000000000000000000001
1000000000000000000100000000000000000000010000000010000000000000000000000000001000000000000000000000000000000000000000000000000001
1000000000000000000100000000000000000000010000000000000000000000000000000000001000000000000000000000000000000000000000000000000001
1000000000000000000000000000000000000000010000000010000000000000000000000000000000000000000000000000200000000000000000000000000001
1000000000000000000100000000000000000000010000000010000000000000000000000000001000000000000000000000000000000000000000000000000001
1000000000000000000100000000000000000000010000000010000000000000000000000000001000000000000000000000000000000000000000000000000001
1000000000000000000100000000000000000000010000000010000000000000000000000000001000000000000000000000000000000000000000000000000001
1000000000000000000100000000000000000000010000000010000000000000000000000000001000000000000000000000000000000000000000000000000001
1000000000000000000100000000000000000000010000000010000000000000000000000000001000000000000000000000000000000000000000000000000001
1111111111111111111111111111111011111111111111111111111111110000000000111111111000000000000000000000000000000000000000000000000001
1000000000000000000100000000000010000000010000000010000000000000000000100000001000000000000000000000000000000000000000000000000001
1000000000000000000000000000000010000000010000000010000000000000000000100000001000000000000000000000000000000000000000000000000001
1000000000000000000000000000000010000000010000000000000000000111111111100000001000000000000000000000000000000000000000000000000001
1000000000000000000100000000000010000000010000000010000000000000000000100000001000000000000000000000000000000000000000000000000001
1011111111111111111111111111111110000000000000000010000000000000000000100000001000000000000000000000000000000000000000000000000001
1000000000000000000000000000000000000000010000000000000000000000000000100000001000000000000000000000000000000000000000000000000001
1000000000000000000100000000000000000000010000000010000000000000000000100000001000000000000000000000000000000000000000000000000001
1000000000000000000100000000000000000000010000000010000000000000000000000000001000000000000000000000000000000000000000000000000001
1000000000000000000100000000000000000000010000000010000000000000000000000000001000000000000000000000000000000000000000000000000001
1111111101111111111111110000111111111111111111111111111111111011111111111111111000000000000000000000000000000000000000000000000001
11111111011111111111111111111                     11111111111011111111111111111000000000000000000000000000000000000000000000000001
1111011101101101101101101111111111111111111111111111111111111111111111111111111000000000000000000000000000000000000000000000000001
1000000000000000000100000000000000000000010000000011000000000000000000000002001000000000000000000000000000000000000000000000000001
1000000000000000000100000000000000000000010000000010000000000000000000000000001000000000000000000000000000000000000000000000000001
1000000000000000000100000000000000000000010000000011000000000000000000100000001000000000000000000000000000020000000000000000000001
1000000000000000000100000000000000000000010000000010000000000000000000000000001000000000000000000000000000000000000000000000000001
1000000000000000000100000000000000000000010000000000000000000000000000000000001000000000000000000000000000000000000000000000000001
1000000000000000000000000000000000000000010000000010000000000000000000000000001000000000000000000000000000000000000000000000000001
1000000000000000000100000000000000000000010000000010000000000000000000000000001000000000000000000000000000000000000000000000000001
1000000000000000000100000000000000000000010000000010000000000000000000000000001000000000000000000000000000000000000000000000000001
1000000000000000000100000000000000000000010000000010000000000000000000000000001000000000000000000000000000000000000000000000000001
1000000000000000000100000000000000000000010000000010000000000000000000000000001000000000000000000000000000000000000000000000000001
1000000000000000000100000000000000000000010000000010000000000000000000000000001000000000000000000000000000000000000000000000000001
1111111111111111111111111111111011111111111111111111111111110000000000111111111000000000000000000000000000000000000000000000000001
1000000000000000000100000000000010000000010000000010000000000000000000100000001000000000000000000000000000000000000000000000000001
1000000000000000000000000000000010000000010000000010000000000000000000100000001000000000000000000000000000000000000000000000000001
1000000000000000000000000000000010000000010000000000000000000111111111100000001000000000000000000000000000000000000000000000000001
1000000000000000000100000000000010000000010000000010000000000000000000100000001000000000000000000000000000000000000000000000000001
1011111111111111111111111111111110000000000000000010000000000000000000100000001000000000000000000000000000000000000000000000000001
1000000000000000000000000000000000000000010000000000000000000000000000100000001000000000000000000000000000000000000000000000000001
1000000000000000000100000000000000000000010000000010000000000000000000100000001000000000000000000000000000000000000000000000000001
1000000000000000000100000000000000000000010000000010000000000000000000000000001000000000000000000000000000000000000000000000000001
1000000000000000000100000000000000000000010000000010000000000000000000000000001000000000000000000000000000000000000000000000000001
1111111101111111111111111111111111111111111111111111111111111111111111111111111111111111111111111111111111111111111111111111111111
1111011101101101101101101111111111111111111111111111111111111111111111111111111111111111111111111111111111111111111111111111111111
1000000000000000000100000000000000000000010000000011000000000000000000000002001000000000000000000000000000000000000000000000000001
1000000000000000000100000000000000000000010000000010000000000000000000000000001000000000000000000000000000000000000000000000000001
1000000000000000000100000000000000000000010000000011000000000000000000100000001000000000000000000000000000000000000000000000000001
1000000000000000000100000000000000000000010000000010000000000000000000000000001000000000000000000000000000000000000000000000000001
1000000000000000000100000000000000000000010000000000000000000000000000000000001000000000000000000000000000000000000000000000000001
1000000000000000000000000000000000000000010000000010000000000000000000000000001000000000000000000000000000000000000000000000000001
1000000000000000000100000000000000000000010000000010000000000000000000000000001000000000000000000000000000000000000000000000000001
1000000000000000000100000000000000000000010000000010000000000000000000000000001000000000000000000000000000000000000000000000000001
1000000000000000000100000000000000000000010000000010000000000000000000000000001000000000000000000000000000000000000000000000000001
1000000000000000000100000000000000000000010000000010000000000000000000000000001000000000000000000000000000000000000000000000000001
1000000000000000000100000000000000000000010000000010000000000000000000000000001000000000000000000000000000000000000000000000000001
1111111111111111111111111111111011111111111111111111111111110000000000111111111000000000000000000000000000000000000000000000000001
1000000000000000000100000000000010000000010000000010000000000000000000100000001000000000000000000000000000000000000000000000000001
1000000000000000000000000000000010000000010000000010000000000000000000100000001000000000000000000000000000000000000000000000000001
1000000000000000000000000000000010000000010000000000000000000111111111100000001000000000000000000000000000000000000000000000000001
1000000000000000000100000000000010000000010000000010000000000000000000100000001000000000000000000000000000000000000000000000000001
1011111111111111111111111111111110000000000000000010000000000000000000100000001000000000000000000000000000000000000000000000000001
1000000000000000000000000000000000000000010000000000000000000000000000100000001000000000000000000000000000000000000000000000000001
1000000000000000000100000000000000000000010000000010000000000000000000100000001000000000000000000000000000000000000000000000000001
1000000000000000000100000000000000000000010000000010000000000000000000000000001000000000000000000000000000000000000000000000000001
1000000000000000000100000000000000000000010000000010000000000000000000000000001000000000000000000000000000000000000000000000000001
1111111101111111111111110000111111111111111111111111111111111011111111111111111000000000000000000000000000000000000000000000000001
11111111011111111111111111111                     11111111111011111111111111111000000000000000000000000000000000000000000000000001
1111011101101101101101101111111111111111111111111111111111111111111111111111111000000000000000000000000000000000000000000000000001
1000000000000000000100000000000000000000010000000011000000000000000000000002001000000000000000000000000000000000000000000000000001
1000000000000000000100000000000000000000010000000010000000000000000000000000001000000000000000000000000000000000000000000000000001
1000000000000000000100000000000000000000010000000011000000000000000000100000001000000000000000000000000000000000000000000000000001
1000000000000000000100000000000000000000010000000010000000000000000000000000001000000000000000000000000000000000000000000000000001
1000000000000000000100000000000000000000010000000000000000000000000000000000001000000000000000000000000000000000000000000000000001
1000000000000000000000000000000000000000010000000010000000000000000000000000001000000000000000000000000000000000000000000000000001
1000000000000000000100000000000000000000010000000010000000000000000000000000001000000000000000000000000000000000000000000000000001
1000000000000000000100000000000000000000010000000010000000000000000000000000001000000000000000000000000000000000000000000000000001
1000000000000000000100000000000000000000010000000010000000000000000000000000001000000000000000000000000000000000000000000000000001
1000000000000000000100000000000000000000010000000010000000000000000000000000001000000000000000000000000000000000000000000000000001
1000000000000000000100000000000000000000010000000010000000000000000000000000001000000000000000000000000000000000000000000000000001
1111111111111111111111111111111011111111111111111111111111110000000000111111111000000000000000000000000000000000000000000000000001
1000000000000000000100000000000010000000010000000010000000000000000000100000001000000000000000000000000000000000000000000000000001
1000000000000000000000000000000010000000010000000010000000000000000000100000001000000000000000000000000000000000000000000000000001
1000000000000000000000000000000010000000010000000000000000000111111111100000001000000000000000000000000000000000000000000000000001
1000000000000000000100000000000010000000010000000010000000000000000000100000001000000000000000000000000000000000000000000000000001
1011111111111111111111111111111110000000000000000010000000000000000000100000001000000000000000000000000000000000000000000000000001
1000000000000000000000000000000000000000010000000000000000000000000000100000001000000000000000000000000000000000000000000000000001
1000000000000000000100000000000000000000010000000010000000000000000000100000001000000000000000000000000000000000000000000000000001
1000000000000000000100000000000000000000010000000010000000000000000000000000001000000000000000000000000000000000000000000000000001
1000000000000000000100000000000000000000010000000010000000000000000000000000001000000000000000000000000000000000000000000000000001
1111111111111111111111111111111111111111111111111111111111111111111111111111111111111111111111111111111111111111111111111111111111
1111011101101101101101101111111111111111111111111111111111111111111111111111111111111111111111111111111111111111111111111111111111
1000000000000000000100000000000000000000010000000011000000000000000000000002001000000000000000000000000000000000000000000000000001
1000000000000000000100000000000000000000010000000010000000000000000000000000001000000000000000000000000000000000000000000000000001
1000000000000000000100000000000000000000010000000011000000000000000000100000001000000000000000000000000000000000000000000000000001
1000000000000000000100000000000000000000010000000010000000000000000000000000001000000000000000000000000000000000000000000000000001
1000000000000000000100000000000000000000010000000000000000000000000000000000001000000000000000000000000000000000000000000000000001
1000000000000000000000000000000000000000010000000010000000000000000000000000001000000000000000000000000000000000000000000000000001
1000000000000000000100000000000000000000010000000010000000000000000000000000001000000000000000000000000000000000000000000000000001
1000000000000000000100000000000000000000010000000010000000000000000000000000001000000000000000000000000000000000000000000000000001
1000000000000000000100000000000000000000010000000010000000000000000000000000001000000000000000000000000000000000000000000000000001
1000000000000000000100000000000000000000010000000010000000000000000000000000001000000000000000000000000000000000000000000000000001
1000000000000000000100000000000000000000010000000010000000000000000000000000001000000000000000000000000000000000000000000000000001
1111111111111111111111111111111011111111111111111111111111110000000000111111111000000000000000000000000000000000000000000000000001
1000000000000000000100000000000010000000010000000010000000000000000000100000001000000000000000000000000000000000000000000000000001
1000000000000000000000000000000010000000010000000010000000000000000000100000001000000000000000000000000000000000000000000000000001
1000000000000000000000000000000010000000010000000000000000000111111111100000001000000000000000000000000000000000000000000000000001
1000000000000000000100000000000010000000010000000010000000000000000000100000001000000000000000000000000000000000000000000000000001
1011111111111111111111111111111110000000000000000010000000000000000000100000001000000000000000000000000000000000000000000000000001
1000000000000000000000000000000000000000010000000000000000000000000000100000001000000000000000000000000000000000000000000000000001
1000000000000000000100000000000000000000010000000010000000000000000000100000001000000000000000000000000000000000000000000000000001
1000000000000000000100000000000000000000010000000010000000000000000000000000001000000000000000000000000000000000000000000000000001
1000000000000000000100000000000000000000010000000010000000000000000000000000001000000000000000000000000000000000000000000000000001
1111111101111111111111110000111111111111111111111111111111111011111111111111111000000000000000000000000000000000000000000000000001
11111111011111111111111111111                     11111111111011111111111111111000000000000000000000000000000000000000000000000001
1111011101101101101101101111111111111111111111111111111111111111111111111111111000000000000000000000000000000000000000000000000001
1000000000000000000100000000000000000000010000000011000000000000000000000002001000000000000000000000000000000000000000000000000001
1000000000000000000100000000000000000000010000000010000000000000000000000000001000000000000000000000000000000000000000000000000001
1000000000000000000100000000000000000000010000000011000000000000000000100000001000000000000000000000000000000000000000000000000001
1000000000000000000100000000000000000000010000000010000000000000000000000000001000000000000000000000000000000000000000000000000001
1000000000000000000100000000000000000000010000000000000000000000000000000000001000000000000000000000000000000000000000000000000001
1000000000000000000000000000000000000000010000000010000000000000000000000000001000000000000000000000000000000000000000000000000001
1000000000000000000100000000000000000000010000000010000000000000000000000000001000000000000000000000000000000000000000000000000001
1000000000000000000100000000000000000000010000000010000000000000000000000000001000000000000000000000000000000000000000000000000001
1000000000000000000100000000000000000000010000000010000000000000000000000000001000000000000000000000000000000000000000000000000001
1000000000000000000100000000000000000000010000000010000000000000000000000000001000000000000000000000000000000000000000000000000001
1000000000000000000100000000000000000000010000000010000000000000000000000000001000000000000000000000000000000000000000000000000001
1111111111111111111111111111111011111111111111111111111111110000000000111111111000000000000000000000000000000000000000000000000001
1000000000000000000100000000000010000000010000000010000000000000000000100000001000000000000000000000000000000000000000000000000001
1000000000000000000000000000000010000000010000000010000000000000000000100000001000000000000000000000000000000000000000000000000001
1000000000000000000000000000000010000000010000000000000000000111111111100000001000000000000000000000000000000000000000000000000001
1000000000000000000100000000000010000000010000000010000000000000000000100000001000000000000000000000000000000000000000000000000001
1011111111111111111111111111111110000000000000000010000000000000000000100000001000000000000000000000000000000000000000000000000001
1000000000000000000000000000000000000000010000000000000000000000000000100000001000000000000000000000000000000000000000000000000001
1000000000000000000100000000000000000000010000000010000000000000000000100000001000000000000000000000000000000000000000000000000001
1000000000000000000100000000000000000000010000000010000000000000000000000000001000000000000000000000000000000000000000000000000001
1000000000000000000100000000000000000000010000000010000000000000000000000000001000000000000000000000000000000000000000000000000001
1111111111111111111111111111111111111111111111111111111111111111111111111111111111111111111111111111111111111111111111111111111111


