R 900 500
NO ./texture/tron2.xpm
SO ./texture/tron0.xpm
WE ./texture/tron0.xpm
EA ./texture/tron2.xpm
S ./texture/enemy.xpm
F 0,0,0
C 0,0,0


        1111111111111111111111111                111111111
        10000000000000000000000011111111111111111000000001
        10000000000000000020000000000000000000000000000011
        10000000000000200000000011111111011111111100000011
111111111000000000000000000000001      101       111111111
120000000000000000000111111111111      101 
10000000020000000000000010201          101 
11110111011011011011011011111           1
11000000000000000000000002001
10002000000000000000000000001
12000000000000000000000000001
110N00111010101111101111000111
11110111 1110101 101111010001
11111111 1111111 111111111111
