R 1900 1000
NO ./texture/wallbrick.xpm
SO ./texture/wallbrick2.xpm
WE ./texture/wallbrick2.xpm
EA ./texture/wallbrick.xpm
S ./texture/zombiehd.xpm
F 0,0,0
C 0,0,0


111111111111111111111111111111111111111111111111111111111111111111111111111111111111111111111
111111111111111111111111111111111100000000000000000000000001111111111111111111111111111111111
1111111111111111111111111111111111000000000000S0000000000001111111111111111111111111111111111
111111111111111111111111111111111100000000000000000000000001111111111111111111111111111111111
111111111111111111111111111111111100000000000000000000000001111111111111111111111111111111111
111111111111111111111111111111111100000000000000000000000001111111111111111111111111111111111
111111111111111111111111111111111100000000000000000000000001111111111111111111111111111111111
111111111111111111111111111111111100000000000000000000000001111111111111111111111111111111111
100000000000000000000000000000000000000000000000000000000001111111111111111111111111111111111
100000000000000000000000000000000000000000000000000000000001111111111111111111111111111111111
100000000000000000000000000000000000000000000000000000000001111111111111111111111111111111111
100000000000000000000000000000000111111111111100111111111111111111111111111111111111111111111
100000000000000000000000000000000111111111111100111111111111111111111111111111111111111111111
100000000000000000000000000000000100000000000000000000000001100000000000000000000011111111111
100000000000000000000000000000000100000000000000000000000001100000000000000000000011111111111
100000000000000000000000000000000100000000000000000000000001100000000000000000000011111111111
100000000000000000000000000000000100000000000000000000000001100000000000000000000011111111111
111111111111111110011111111111111100000000000000000000000000000000000000000000000011111111111
111111111111111110011111111111111100000000000000000000000000000000000000000000000011111111111
111111111111111110011111111111111100000000000000000000000001100000000000000000000011111111111
111111111111111110011111111111111100000000000000000000000001100000000000000000000011111111111
111111111111111110011111111111111100000000000000000000000001100000000000000000000011111111111
111111111111111110011111111111111100000000000000000000000001100000000000000000000011111111111
111111111111111110011111111111111111111111111001111111111111111111111110011111111111111111111
111111111111111110011111111111111111111111111001111111111111111111111110011111111111111111111
111111000000000000000000000000011100000000000000000000000001100000000000000000000011111111111
111111000000000000000000000000011100000000000000000000000001100000000000000000000011111111111
111111000000000000000000000000011100000000000000000000000001100000000000000000000011111111111
111111000000000000000000000000011100000000000000000000000001100000000000000000000011111111111
111111000000000000000000000000000000000000000000000000000000000000000000000000000011111111111
111111000000000000000000000000000000000000000000000000000000000000000000000000000011111111111
111111000000000000020000000000011100000000000000000000000001100000000000000000000011111111111
111111000000000000000000000000011100000000000000000000000001100000000000000000000011111111111
111111000000000000000000000000011100000000000000000000000001100000000000000000000011111111111
111111000000000000000000000000011100000000000000000000000001100000000000000000000011111111111
111111111111111111111111111111111111111111111111111111111111111111111111111111111111111111111