R 900 500
NO ./texture/tron0.xpm
SO ./texture/tron2.xpm
WE ./texture/tron2.xpm
EA ./texture/tron0.xpm
S ./texture/moto1.xpm
F 0,0,0
C 0,0,0


111111111111111111111111
100000000000000000000001
100002000000000000000001
100000000000000000000001
100000000000000000000001
100000000000011111111111
100000000000010000000001
100000000000010000000001
100000000000010000000001
10000000000001111000N001
100000000000000000000001
100000000000000000000001
111111111111111111111111
