R 900 500
NO ./texture/tron0.xpm
SO ./texture/tron1.xpm
WE ./texture/tron2.xpm
EA ./texture/tron3.xpm
S ./texture/enemy.xpm
F 0,0,0
C 0,0,0


        1111111111111111111111111                111111111
        10000000000000000000000011111111111111111000000001
        10000000000000000020000000000200000000000000000011
        10000000000000200000000011111111111111111100000011
111111111000000000000000000000001                111111111
120000000000000000000111111111111
10000000020000000000000010201
11110111011011011011011011111
11000000000000000000000000001
10002000000000000000000002001
12000000000000000000000000001
1100N00111010101111101111000111
11110111 1110101 101111010001
11111111 1111111 111111111111
